19 1 18 17 0
口口口口口口口口口口口口口口口口口口口
口　　　　　口　　　　　　　　　　　　
口口口　口口口　口　口口口口口　口口口
口　　　　　口　口　　　　　口　　　口
口口口　口　口　口口口口口　口口口口口
口　口　口　口　口　　　口　　　　　口
口　口　口口口　口口口　口口口口口　口
口　　　　　　　　　　　口　　　　　口
口　口口口口口口口口口　口　口口口口口
口　口　　　　　　　口　口　口　　　口
口　口　口口口口口　口　口　口　口　口
口　　　口　　　　　口　口　　　口　口
口　口口口　口口口口口口口　口口口　口
口　口　口　　　　　　　口　口　　　口
口　口　口口口口口口口　口　口　口　口
口　口　口　　　口　　　口　口　口　口
口　口　口　口　口　口口口口口　口　口
　　口　　　口　　　　　　　　　口　口
口口口口口口口口口口口口口口口口口口口
