33 32 16 29 32
口口口口口口口口口口口口口口口口口口口口口口口口口口口口口口口口口
口　　　　　　　　　口　　　　口　　　　口　　　　　　　　　　　口
口　口口口口口口口　口　口口口口　口口　口　口口口口口口口口口　口
口　口　　　　　　　口　口　　　　　口　口　　　　　　　　　口　口
口　口　口口口口口口口　口　口口口　口　口口口口口口口口口　口　口
口　口　口　　　　　　　口　　口　　口　　　　　　　　　口　口　口
口　口　口　口口口口口口口口　口　口口口口　口口口口口　口　口　口
口　口　口　口　　　口　　　　口　　　　口　口　口　口　口　口　口
口　口　口　口　口　口　口口口口口口口　口　口　口　口　口　口　口
口　口　口　口　口　口　口　　　　　口　口　口　口　口　口　口　口
口　口　口　口　口　口　口　　　　　口　口　口　口　口　口　口　口
口　口　　　口　口　口　口　　　　　口　口　口　口　口　　　口　口
口　口口口　口　口　口　口　　　　　口　口　口　口　口　口口口　口
口　　　口　口　口　口　口　　　　　口　口　口　口　口　口　　　口
口口口　口　口　口　口　口　　　　　口　口　口　口　口　口　口口口
口　　　口　口　口　口　口　　　　　口　口　口　口　口　口　　　口
口　口口口　口　口　口　口　　　　　口　口　口　　　口　口　口　口
口　口　　　口　口　口　口　　　　　口　口　口　口口口　口　口　口
口　口　口　口　口　口　口　　　　　口　口　口　口　　　口　口　口
口　口　口　口　口　口　口　　　　　口　口　口　口　口　口　口　口
口　口　口　口　口　口　口　　　　　口　口　口　口　口　口　口　口
口　口　口　口　口　口　口　　　　　口　口　口　口　口　口　口　口
口　口　口　口　口　口　口　　　　　口　口　口　口　口　口　口　口
口　口　口　口　口　口　口　　　　　口　口　口　口　口　口　口　口
口　口　口　口　口　口　口口口　口口口　口　口　口　口　口　口　口
口　口　口　口　口　口　　　口　口　　　口　口　　　口　口　口　口
口　口　口　口　口　口口口　口　口　口口口　口　口口口口口　口　口
口　口　口　　　口　　　口　口　口　　　　　　　口　　　　　口　口
口　口　口口口口口口口口口　口　口口口口口口口口口口口口口口口　口
口　口　　　　　　　　　　　口　　　　　　　　　　　　　　　　　　
口　口口口口口口口口口口口口口口口口口口口口口口口口口口口口口口口
口　　　　　　　　　　　　　　　　　　　　　　　　　　　　　　　口
口口口口口口口口口口口口口口口口　口口口口口口口口口口口口口口口口