61 11 0 0 37
口口口口口口口口口口口口口口口口口口口口口口口口口口口口口口口口口口口口口　口口口口口口口口口口口口口口口口口口口口口口口
口　　　　　　　　　　　　　　　口　　　　　　　　　　　　　　　　　口　口　　　　　口　　　　　口　　　　　口　　　　　口
口　口口口口口口口口口口口口口　口　口口口口口口口口口口口口口　口　口　口口口口口　口　口口口　口口口　口　口　口口口　口
口　口　　　　　口　　　　　　　口　口　　　　　　　　　　　口　口　口　　　　　口　口　口　　　　　　　口　口　口　　　口
口　口　口口口　口　口口口口口口口　口　口口口口口口口口口口口　口　口口口　口　口　口　口口口口口口口口口　口　口　口口口
口　口　　　口　口　　　　　　　口　口　　　　　口　　　　　　　口　　　　　口　口　口　　　口　　　　　　　口　口　　　口
口　口　口　口口口口口口口口口　口　口　口口口　口　口口口口口　口口口口口口口口口　口口口　口　口口口口口口口　口口口口口
口　口　口　口　　　　　　　　　口　口　　　口　口　口　　　口　口　　　　　　　口　口　　　口　　　　　　　　　口　　　口
口　口　口　口　口口口口口口口　口　口　口口口　口　口　口　口　口　口口口口口　口　口　口　口口口口口口口口口口口　口　口
口　口　口　口　口　　　　　口　口　口　口　　　口　口　口　口　口　口　　　口　口　口　口　口　　　　　　　　　　　口　口
口　口口口　口　口　口　口口口　口　口　口　口口口　口　口　口　口　口　口　口　口　口　口　口　口口口口口口口口口口口　口
　　　　　　口　口　口　口　　　口　口　口　　　口　口　口　口　口　口　口　口　　　口　口　口　　　口　　　　　　　口　口
口口口口口口口　口　口口口　口口口　口　口口口　口　口　口　口　口　口　口　口口口口口　口　口口口　口　口口口口口　口　口
口　　　　　　　口　口　　　口　　　口　口　口　口　口　口　　　口　口　口　口　　　　　口　口　口　口　口　　　口　口　口
口　口口口口口口口　口　口口口　口口口　口　口　口　口口口口口口口　口　口口口　口口口　口　口　口　口　口　口　口口口　口
口　口　　　　　　　口　　　口　口　　　口　口　口　　　　　　　　　口　　　　　　　口　口　口　口　口　口　口　口　　　口
口　口　口口口口口　口口口　口　口　口口口　口　口口口口口口口口口口口口口口口口口口口　口　口　口　口　口　口　口　口　口
口　口　　　　　口　　　口　口　口　　　　　口　　　　　　　　　　　　　　　　　　　口　口　　　口　　　口　口　　　口　口
口　口口口口口口口　口口口　口　口口口口口口口　口口口口口口口口口口口口口口口口口　口　口口口口口口口　口　口口口口口　口
口　　　　　　　口　　　口　口　　　　　　　　　口　　　口　　　　　　　　　　　口　口　　　　　　　　　口　口　　　口　口
口　口口口口口　口　口　口　口口口口口口口口口口口　口　口　口口口口口口口口口口口　口口口口口口口口口口口　口　口　口　口
口　口　　　口　口　口　　　　　口　　　　　　　　　口　口　口　　　口　　　　　口　口　　　　　　　　　　　口　口　口　口
口　口口口　口　口口口口口口口口口　口口口口口　口口口　口　口　口　口　口口口　口　口　口口口口口口口口口口口　口　口　口
口　口　　　口　　　　　　　　　口　口　口　口　口　　　口　　　口　口　口　口　口　口　　　　　　　　　　　口　口　口　口
口　口　口口口口口口口口口口口　口　口　口　口　口　口口口口口口口口口　口　口　口　口　口口口口口口口口口　口　口　口　口
口　口　　　　　　　　　　　口　口　口　口　口　口　口　　　　　　　　　口　　　口　口　　　口　　　　　　　口　口　口　口
口　口口口口口　口口口口口　口　口　口　口　口　口　口　口口口口口口口口口　口口口　口口口口口　口口口口口口口　口口口　口
口　　　　　　　口　　　　　口　口　口　口　口　口　口　口　口　　　　　口　口　口　口　　　　　口　　　口　　　　　口　口
口口口口口　口口口口口口口口口　口　口　口口口　口　口　口　口　口　口　口　口　口　口　口口口口口　口　口　口口口　口　口
口　　　　　口　　　　　　　口　口　口　　　口　口　口　口　口　口　口　口　　　口　　　口　　　　　口　口　　　口　　　口
口　口口口口口　口口口口口　口　口　口口口　口　口　口　口　口　口　口口口口口　口口口口口　口口口　口　口口口　口口口口口
口　口　　　口　口　　　口　口　口　　　口　口　口　口　口　口　口　　　　　　　　　　　口　口　　　口　　　口　口　　　口
口　口　口口口　口　口　口　口　口口口　口　口　口　口　口　口　口口口口口口口口口口口口口　口　口口口口口口口　口　口口口
口　口　口　　　口　口　口　口　　　　　　　口　口　　　口　口　口　　　　　口　　　　　　　口　　　　　　　　　口　　　口
口　口　口　口口口　口口口　口口口口口口口口口　口口口口口　口　口　口口口　口　口口口口口口口口口口口口口口口口口口口　口
口　口　口　口　　　　　　　　　　　　　　　　　口　　　　　　　口　　　口　口　口　　　　　　　　　　　口　　　　　　　口
口　口　口　口口口口口口口口口口口口口口口口口口口口口口口口口　口　口口口　口　口　口口口口口口口口口　口　口　口口口　口
口　　　口　口　　　　　　　　　　　　　　　　　　　　　　　口　口　口　　　口　口　口　　　　　　　　　口　口　口　口　口
口口口口口　口　口口口口口口口口口口口口口口口口口口口口口　口　口　口　口口口　口　口　口口口口口口口口口口口　口　口　口
口　　　　　口　　　　　　　口　口　　　　　口　　　　　口　口　口　口　　　口　　　口　口　　　　　　　　　　　口　口　口
口　口口口　口口口口口口口　口　口　口　口　口口口口口　口　口　口　口口口　口口口口口　口口口口口　口口口口口口口　口　口
口　口　口　口　　　　　口　口　口　口　口　　　　　　　口　口　口　口　口　　　　　口　　　　　口　　　　　　　口　口　口
口　口　口　口　口口口　口　口　口　口　口口口口口口口　口　口　口　口　口　口口口　口口口口口　口口口口口口口　口　口　口
口　口　　　口　口　口　口　口　口　口　口　　　　　口　口　口　口　　　口　口　　　　　　　口　　　　　　　　　口　　　口
口　口　口口口　口　口　口　口　口　口　口　口口口　口　口　口　口口口口口　口口口口口口口口口口口口口口口口口口口　口口口
口　口　　　口　口　口　　　口　　　口　口　口　口　口　口　口　　　　　　　口　　　　　　　　　　　　　　　　　口　口　口
口　口口口口口　口　口口口口口口口　口　口　口　口　口　口　口口口口口口口　口　口口口口口口口口口口口口口口口　口　口　口
口　　　　　　　口　口　　　　　口　口　口　口　口　口　口　口　　　　　口　口　　　口　　　　　　　　　口　　　口　口　口
口　口口口口口口口　口　口　口　口　口　口　口　口　口　口　口　口口口口口　口口口　口　口　口口口口口口口　口　口　口　口
口　口　　　口　　　口　口　口　口　口　口　口　口　口　口　口　　　　　　　　　口　口　口　　　口　　　　　口　口　口　口
口　口　口　口　口口口　口　口　口　口　口　口　口　口　口　口　口口口口口口口　口　口口口口口　口　口口口口口　口　口　口
口　口　口　口　　　　　口　口　口　口　口　口　口　口　口　口　　　口　　　口　口　口　　　　　口　口　　　口　口　口　口
口　口　口　口口口口口口口　口　口　口　口　口　口　口　口　口口口口口　口　口　口　口　口口口　口　口　口　口　口　口　口
口　口　口　　　　　　　　　口　口　口　口　　　口　　　口　　　　　　　口　口　口　口　口　口　口　口　口　口　口　口　口
口　口　口口口口口口口口口口口　口口口　口　口口口口口口口口口口口口口　口　口　口　口　口　口　口　口　口　口　口　口　口
口　口　口　　　口　　　口　口　口　　　口　口　　　　　　　　　　　口　口　口　口　口　口　　　口　口　口　口　口　口　口
口　口　口　口　口　口　口　口　口　口口口　口　口口口口口口口口口　口口口　口　口　口　口口口口口　口　口　口　口　口　口
口　口　口　口　　　口　　　口　口　口　　　口　口　　　　　　　　　　　　　口　口　口　口　　　　　口　口　　　口　口　口
口　口　口　口口口口口口口口口　口　口　口口口　口口口口口口口口口口口口口口口口口　口　口　口口口口口口口口口口口　口　口
口　　　口　　　　　　　　　　　　　口　　　口　　　　　　　　　　　　　　　　　　　　　口　　　　　　　　　　　　　　　口
口口口口口口口口口口口口口口口口口口口口口口口口口口口口口口口口口口口口口口口口口口口口口口口口口口口口口口口口口口口口口
